6 10
|--------|
|FFF|..P.|
|........|
|FF...@|.|
|..F..P|.|
|--------|